  ###################################################
  #                                                 #
  #                                                 #
  #                                                 #
  #####                                         #####
  #                                                 #
  #                        J                        #
  #                   ###########                   #
  #                       ⚾                         #
  #                                                 #
  #             >  <                 *  ^           #
  #         ###########          ###########        #
  #                                                 #
  #                                                 #
  ########                                   ########
  #                                                 #
  #                                                 #
  #                                                 #
  #                       O                         #
  ###################################################