#############################################################################
#                                                                                                #
#                                                                                                #
#                                                                                                #
#                                                                                                #
#                                                                                                #
#                                                                                                #
#                                                                                                #
#                                                                                                #
#                         #                          #                                           #
#                         #                          #                                           #
#                    ###########                 #########                                       #
#                                                                                                #
#                                                                                                #
#                                                                                                #
#                                                                                                #
#                                                                                                #
#                                      J                                                         #
#        ###########              ###########                  ########                          #
#                                                                                                #
#                                                                                                #
#                                                                                                #
#                                                                                                #
#                                                                                                #
#                    ###########              ###########                                        #
#                                                                                                #
#                                                                                                #
#                                                                                                #
#                                                                                                #
#           >  <                                             *  ^                                #
#        ###########              ###########            ###########                             #
#                                                                                                #
#                                                                                                #
#                                                                                                #
#                                                                                                #
#                                      ⚾                                                         #
#                 O                                           T                                  #
############################################################################