###################################################                                                                          #
#                                                #
#                                                #
#                                                #
#                                                #
#                                                #
#                                                #
#                                                #
#                                                #
#                                                #
#     ###########               ###########      #
#                                                #
#                                                #
#                                                #
#                                                #
#                      J                         #
#                 ###########                    #
#                                                #
#                                                #
#                                                #
#                                                #
#        >  <                       *  ^         #
#     ###########               ###########      #
#                                                #
#                                                #
#                                                #
#                                                #
#                      ⚾                         #
#       O                                T       #
##################################################